director	manager
business	project
director	vp
technologies	technology
executive	manager
fb	facebook
comp	computer
account	sales
inc	inc.
hr	recruiter
engineer	engineering
product	project
pharma	pharmaceuticals
affairs	relations
tech	technologies
hr	recruitment
planner	planning
finance	financial
advertising	marketing
manager	supervisor
digital	online
market	marketing
tech	technology
laboratories	labs
art	creative
procurement	sourcing
media	public
head	manager
qa	test
internet	online
graphic	web
recruiter	recruitment
developer	engineer
director	head
client	community
district	regional
it	technology
accounting	finance
business	corporate
care	service
limited	ltd
manager	vp
audit	auditor
coordinator	planner
construction	project
trader	trading
global	international
trainer	training
developer	development
bank	banking
